111111111111111111111
1C00000000C00000000C1
101111011011011011111
101001001001001001001
1P1111011011111011001
1000000000C1000000011
101111011011011011001
101001001001C010010C1
1C1111011011011011001
1000000000C0000000011
1011110110110110001C1
1000C10010010000E0001
111111111111111111111
