111111111111111111
1P0000C00C00000001
101111111111111101
100000C00C00000001
111110111110111111
100C00000000000C01
101111101011111101
1C0000111100000C01
101111101011111101
100000C00C0000E001
111111111111111111