1111111111111
1P00000C00001
1011111111101
1C00C0000C001
1101110111111
100000E000001
1111010111111
1C00C0000C001
1011111111101
1000000C00001
1111111111111
