1111111
1010C11
11111E1
100P001
1111111