1111111111111
1C0000000C001
1000P00000001
1000111111001
1000000000001
1C00000E00C01
1111111111111
