111111111111111111111111
1P0000000C000000000000X1
1C1111011111011111011101
100000000000000000000CN1
1X1111N11111011111011101
100000C00000000000C00001
101111011111011111011101
100000000000N00000C000X1
1N1111C11111011111011101
100C00X00000C00000N00001
101111011111011111011101
1000000X000000C00000E111
111111111111111111111111
