111111111111111111111111
1P0000000C000000000001N1
1C1111011111011111011111
100000000000000000000CN1
101111011111011111011101
100000C00000N00000C00001
101111011111011111011101
1M0000000000000000C000N1
101111C11111011111011101
100C00000000C000000000N1
101111011111011111011101
1N000000000000C00000E111
111111111111111111111111
