1111111111111
1P0000C000001
1011111111101
1000000000001
1000X00X00001
1011111111101
1000000000001
1C00000000001
1011111111101
1000000000001
1000X0C000001
1000000000001
1000000E00001
1111111111111