1111111111111111111111
1E000000000000000001
1000011111100000X001
1P00X11111100000001
1000011111100000001
1000000000000X00001
1111111111111111111 