11111111111111111111111
1P000000C00000C00000N11
101111011111011101110N1
100000000000C00000000N1
101111011111011101110N1
10C000000000000C0000N11
101111011111011101110M1
10000000E000000000000N1
11111111111111111111111
