11111111111111
1P00000C000001
10111101110001
1000000000C0M1
10111101110001
10C00000000011
1N00000E000001
11111111111111
