11111
1C001
1E101
100P1
11111