1111111111111111111111111
1P000000000C00M0000C0001
1000111111111111111110M1
10C0000M00000000000000C1
1011111111111111111111M1
1000000M0000C00M00000001
1M11111111111111111111M1
1C00000000000000M0000001
1111111111111111111111E1 