11111111111111111111111
1P000000000000000000001
10111011101110111011101
1000N000C00X0000C000001
10111011101110111011101
100000C0N00000X0000C001
10111011101110111011101
1000X000000N00C0000X001
10111011101110111011101
100C0N000C00X0000000001
10111011101110111011101
1000000X0X000000C000E11
11111111111111111111111
