1111111111
1P00000C01
1000000001
10C0000C01
1000000E01
1111111111
